#########################
#...........#...........#
#........C..#..G........#
#...M...#########.......#
#...........#...........#
#...........#...........#
######......#...#####...#
#...........#...........#
#.......#######....M....#
#...........#...........#
######......#...........#
#...........#..######...#
#..P....#####...........#
#.....................E.#
#########################