#########################
#...........#...........#
#........C..#..G........#
#.......#########.......#
#...........#...........#
#...........#...........#
#######.....#...#####...#
#...........#...........#
#.........#####...E.....#
#...........#...........#
######......#...........#
#...........#..######...#
#..P....#####...........#
#.......................#
#########################