#########################
#...........#...........#
#........C..#..G........#
#.......#########.......#
#...........#...........#
#...........#...........#
######.M....#...#####...#
#...........#...........#
#.......#######...E.....#
#...........#...........#
######......#...........#
#...........#..######...#
#..P....#####...........#
#.......................#
#########################