#########################
#.........#.............#
#.........#G............#
#.........######........#
#....M.............#....#
#.......................#
#..C...........#........#
#.#######......######...#
#.......................#
#........#####..........#
#..................E....#
#..............######...#
#..P........#L#.........#
#.........##............#
#########################