#########################
#.........#.............#
#..C......#.....G.......#
#.........######........#
#....M.............#....#
#..............M........#
#..............#........#
#.#######......######...#
#.......................#
#........#####..........#
#..................E....#
#..............######...#
#..P........###.........#
#.........##............#
#########################