#########################
#.........#.............#
#..C......#.....G.......#
#.........######........#
#....M.............#....#
#.......................#
#...............#.......#
#.#######......######...#
#.......................#
#........#####..........#
#..................E....#
#..............######...#
#..P........#L#.........#
#.........##............#
#########################