#########################
#.......................#
#..............#........#
#..............#........#
#..............#....G...#
#.........###############
#.......................#
#....E..................#
#..###########..........#
#.....................C.#
#..................####.#
#.............#.........#
#.............#.....P...#
#.............#.........#
#########################